1111111111111111
1000011111100041
1011000000001101
1000611311180001
1010170000010101
1010109999710101
1010170000010101
1000611121180001
1011000000001101
1000011111100051
1111111111111111